w,w,w,w,w,w,w,w,w,w,w,w,w,w,w,w,w,w,w,w,w,w,w,w,w,w,w
w,0,0,0,0,r,0,0,0,0,0,0,0,0,0,0,0,0,0,0,0,0,0,0,0,0,w
w,p,0,0,0,r,0,0,0,0,0,0,0,0,0,0,0,0,0,0,0,0,0,0,0,0,w
w,0,w,0,0,r,0,0,r,0,0,0,0,0,0,0,0,0,0,0,0,0,0,0,0,0,w
w,0,0,0,0,r,0,0,r,0,0,0,0,0,0,0,0,0,0,0,0,0,0,0,0,0,w
w,0,0,0,0,r,0,0,r,0,0,0,0,0,0,0,0,0,0,0,0,0,0,0,0,0,w
w,0,0,0,0,0,0,0,r,0,0,0,0,0,0,0,0,0,0,0,0,0,0,0,0,0,w
w,0,0,0,r,r,0,0,0,0,0,0,0,0,0,0,0,0,0,0,0,0,0,0,0,0,w
w,0,0,0,0,0,0,0,0,0,0,0,0,0,0,0,0,0,0,0,0,0,0,0,0,0,w
w,0,0,0,0,0,0,0,0,0,0,0,0,0,0,0,0,0,1,r,0,0,0,0,0,0,w
w,0,0,0,0,0,r,r,r,0,0,0,0,0,0,0,0,0,0,r,0,0,0,0,0,0,w
w,0,0,0,0,0,0,0,0,0,0,0,0,0,0,0,0,0,0,r,0,0,0,0,0,0,w
w,0,0,0,0,0,0,0,0,0,r,0,0,0,0,0,0,0,0,r,0,0,0,0,0,0,w
w,0,0,0,0,0,0,0,0,0,0,0,0,0,7,0,0,0,0,0,0,0,0,0,0,0,w
w,r,r,1,2,r,4,5,6,7,8,9,0,0,0,0,e,f,0,0,0,0,0,0,0,0,w
w,0,0,0,0,0,0,0,0,a,b,0,0,0,0,0,0,0,0,0,0,0,g,0,0,0,w
w,0,0,0,0,0,0,0,0,c,d,0,0,0,r,r,r,0,0,0,0,0,0,0,0,0,w
w,0,0,0,0,0,0,0,0,0,0,0,0,0,0,0,0,0,0,0,0,0,0,0,0,0,w
w,0,0,0,0,0,0,0,0,0,0,0,0,0,0,0,0,0,0,0,0,0,0,0,0,0,w
w,w,w,w,w,w,w,w,w,w,w,w,w,w,w,w,w,w,w,w,w,w,w,w,w,w,w



