0,0,0,0,0,0,0,0,0,0,0,0,0,0,0,0,0,0,0,0,0,0,0,0,0,0,0,0,0,0,0,w
0,0,0,0,0,0,0,0,0,0,0,0,0,0,0,0,0,0,0,0,0,0,0,0,0,0,0,0,0,0,0,w
0,0,0,0,0,0,0,0,0,0,0,0,0,0,0,0,0,0,0,0,0,0,0,0,0,4,3,4,0,0,0,w
0,p,0,0,0,0,0,0,0,0,0,0,0,0,0,0,0,0,0,4,0,0,0,0,0,0,0,0,4,3,4,w
0,4,3,4,3,4,3,4,3,0,0,e,f,e,f,0,0,0,0,3,0,0,0,0,0,0,0,0,0,0,0,w
0,0,0,0,0,0,0,0,0,0,0,0,0,0,0,0,0,0,0,4,0,0,3,e,f,3,0,0,0,0,0,w
0,0,0,0,4,0,0,0,a,b,4,3,t,0,0,0,0,0,0,3,0,0,0,0,0,0,0,0,0,0,0,w
0,0,0,0,3,0,0,0,c,d,0,0,0,0,0,0,0,0,0,4,0,0,0,0,0,0,0,0,0,0,0,w
0,0,0,0,4,0,0,0,0,0,0,0,0,0,0,g,0,0,0,3,0,0,0,0,0,0,0,0,0,0,0,w
0,0,e,f,3,e,f,0,0,0,0,0,0,0,0,0,0,0,0,4,0,0,0,0,t,a,b,t,0,0,0,w
0,0,0,0,0,0,0,0,0,e,f,t,3,t,0,0,0,0,0,3,0,0,0,0,0,c,d,0,0,0,0,w
0,0,3,0,0,0,0,0,0,0,0,0,0,0,0,0,0,0,0,4,0,0,0,0,0,0,0,0,0,0,0,w
0,0,4,0,0,0,0,0,0,0,0,0,0,0,e,f,3,e,f,3,e,f,0,0,0,0,0,0,0,0,0,w
0,0,3,0,0,0,0,0,0,0,0,0,0,0,0,0,0,0,0,0,0,0,4,0,0,0,0,0,0,0,0,w
0,0,4,0,0,0,0,0,0,0,0,0,0,0,0,0,0,0,0,0,0,0,3,4,0,0,0,0,0,0,0,w
0,0,3,4,e,f,4,3,0,0,0,0,0,0,0,0,0,0,0,0,0,0,0,0,3,0,0,0,0,0,0,w
0,0,0,0,0,0,0,0,0,0,t,3,4,t,0,0,0,0,0,0,0,4,3,t,4,0,0,0,0,0,0,w
w,w,w,w,w,w,w,w,w,w,w,w,w,w,w,w,w,w,w,w,w,w,w,w,w,w,w,w,w,w,w,w