w,w,w,w,w,w,w,w,w
w,w,w,w,w,w,w,w,w
0,0,0,0,0,3,0,0,w
0,0,0,3,0,3,0,3,w
3,0,0,0,0,0,0,0,w
3,0,3,3,0,0,0,3,w
0,0,0,0,3,0,0,3,w
3,0,0,0,0,0,0,3,w
0,0,0,0,3,0,0,3,w
0,3,3,3,3,0,0,0,w
0,0,0,0,0,0,3,0,w
0,0,0,0,0,3,0,0,w
0,0,4,0,0,0,3,1,w
w,w,w,w,w,w,w,w,w