w,w,w,w,w,w,w,w,w
w,p,0,0,0,r,0,0,w
w,0,w,r,0,r,0,r,w
w,0,0,0,0,0,0,0,w
w,0,r,r,0,0,0,r,w
w,0,0,0,r,0,0,r,w
w,0,0,0,0,0,0,r,w
w,0,0,0,r,0,0,r,w
w,r,r,r,r,0,0,0,w
w,0,0,0,0,0,r,0,w
w,0,0,0,0,r,0,0,w
w,0,4,0,0,0,r,g,w
w,w,w,w,w,w,w,w,w